0   0   0   0   0   0   0   0   0   0   0   0   0   0   0   0   0   0   0   0   0   0   0   0   0   0
0   0   0   0   0   0   0   0   0   0   0   0   0   0   0   0   0   0   0   0   0   0   0   0   0   0
5   1   1   1   1   1   1   1   1   1   1   1   1   1   1   1   1   1   1   1   1   1   1   1   1   6
3  60  60  60  60  60  60  60  60  60  60  60  60  60  60  60  60  60  60  60  60  60  60  60  60   4
3  60  60  60  60  60  60  60  60  60  60  60  60  60  60  60  60  60  60  60  60  60  60  60  60   4
3  60  60  60  60  60  60  27  60  60  60  60  60  60  60  60  60  60  60  60  60  60  60  60  60   4
3  60  60  60  60  60  60  60  60  60  60  60  60  60  60  60  60  60  60  60  60  60  60  60  60   4
3  60  60  60  60  60  60  60  60  60  60  60  60  60  60  60  60  60  60  60  60  60  60  60  60   4
3  60  60  60  60  60  60  60  60  60  60  60  60  60  60   9   2   2   2   2  10  60  60  60  60   4
3  60  60  60  60  60  60  60  60  60  60  60  60  60  60   4   0   0   0   0   3  60  60  60  60   4
7   2   2   2   2   2   2   2   2   2   2   2   2   2   2   8   0   0   0   0   7   2   2   2   2   8
0   0   0   0   0   0   0   0   0   0   0   0   0   0   0   0   0   0   0   0   0   0   0   0   0   0
0   0   0   0   0   0   0   0   0   0   0   0   0   0   0   0   0   0   0   0   0   0   0   0   0   0
0   0   0   0   0   0   0   0   0   0   0   0   0   0   0   0   0   0   0   0   0   0   0   0   0   0